000000000000000000000000000000
000000000000000000000000000000
000000000000000000000000000000
000000000000000000000000000000
000000000000000000000000000000
222222222222222222222222222222
111111111111130110011151110111
111110101430111010111111113133
111110110111014111101111311111
111111411011314011110351101110
011141111151110050511411014111
111111111310141111111111111111
101111131014113140110111011313
011111111111111111111111111110
011111413031011111101111111110
111101113111111001014111101111
141111111131311111101111311110
111111011101101001101101111111
111111111110111101111111111111
311111111113011111051111011101
301110111101111113511000013111
111111111101131111141111111131
111111110101011311111001111311
111115454410111104011011111111
110311005140111111530111011011
111510113011111103101105011111
131115110311111401111110111111
111101111111101111011110111011
011131141110404531101013111110
111111131101311151131011110310
311101111111411111111110111111
511111111011013151111111111311
111111111111111501111011113313
431011101010110115311110131111
101011141110114111111001101011
144011041100104110111111111111
311011311011111001111111110111
111411101111130110111311110113
111111100513114111111111110413
111110110115511113111111111011
111311111111101111111511111100
011104101111111011101110111101
111111111111103111111111111011
311111113111011111013014110101
131100104131111110101111111511
111151101111110111301110110111
140110311114111111111011011101
101010111041011311111011131011
411141141111311111110111114111
111111111111101111111111011111
115111011131410511111111011311
510141111050111111110111111111
131011011111011110411140113111
111101131401111111014101111111
111011011111111415111131411341
133111111111101111510101101111
111111105111111111101010114411
101111011111110001101101111141
010111111111411101111101141111
011111514301013010401111401311
141111103111033111411010110111
111001110111113110111131111140
001111114111131310113110011031
311111101111111011111111100111
101411111001110013111101001511
111111000111011141113111011111
110111011111031000111111111011
110111511101141111103111111135
111101140011411131001110301111
311311110111111110111111111111
011311111131111111113111111111
111101131311050000111111001101
310111111011110111011311111100
111113111111001001111313111311
111131411110111111101111011111
111130011111141111111350111111
113111133110111111111111111111
100011140111031311110100111110
111111131111111101111114110101
104110110111111110310110001111
100130110111011111111311113101
113111511111101111111130111011
101430100011111111310110011111
101140111141111131311111110104
111141011110111111411111111011
140111111111011311151011111311
010111411133101311131111111111
111110031141411110011111101101
110111111013110111300111111144
101000013111110110150011110140
130131110113301111111111130111
100111111111011111110111111111
014010031111111111011110110011
011311111411141111111110011110
111111111111101111111110111011
111311111011111110111111111111
011301115115413111101411110010
111110131011111013011111313111
111011411110111111100011010151
011311011111111111031111111111
