700000000000000000000000000007
700000000000000000000000000007
700000000000000000000000000007
700000000000000000000000000007
700000000000000000000000000007
222222222222222222222222222222
111111111131111111010410111101
111001100101111111011310014111
001111111111011111111411110010
110113110111111111113100111111
101111131000011115010110111311
001111411101111135131103514131
011111144011111115151111111101
111111101001111111101113111111
101101150111154411111110131111
111131111011100111111111111111
011110011101011101001411011111
301311111014341111010111100113
111111111411311511113111411311
111011111111011141001110100111
001111013151111011113004111011
514301310110031110110103100111
113011101101414111011100111011
115101113411111111111101111101
110011101311111111011011311411
111111511101311411101011111311
114511110111111011113411311011
110010111111113151111111101314
011111101131101111110111113150
101131111111000111111011113111
101110111111101111111010115111
011111111111110011001310031310
501113111311101010111130010111
011110111051110111011131100101
001511101104311101113115011103
111111011111110110510101115111
103151011111114300011111001001
111111111111131141101111111101
110113111111010141101111111001
131111113111311111111103111101
104111101111110111110301114111
011110100111101415110041131401
111111010111101111311111111343
111111011115011111111111111111
101111010110111311111111111111
113151101104110111111111311111
111001113111111111141111151111
400143111111144111111311111131
101111111001001110113111311111
141114111111111115011111111111
101111111131111111111011111154
101111110001011110114111114300
113101111111111111111114111113
011010111131111111110411315113
111100114111011301111111150113
111113011111111111111311111111
111101100101011011111111111011
151111141010111111111113104153
011111110151111111101101133101
101050411510111010111111411111
111311011141114113000011111013
111401111011311111111431110111
011311111101011111113110101111
111001111011101001111101010141
111411111110111111111511041130
111051111113140111110111111110
041111111111013105141314111110
510101111110111111101311110111
111111101111001111031111311111
310111110140131100101113111131
011114111111153111511111111013
011111111110111011011111115111
111110111110111313131035111111
001010110114111011101110011001
141111111131141411011301111311
011111111111111111111510141335
011034011310511100111111111100
111411111011111111110101111111
001001110111111311111111101111
111101111141101110111151111013
111041111111111311101011131111
110000111411111110103131111111
111151011111111111111141110111
111111003111101111131411101111
111010111111115111111111101311
010131110110105111111151111111
011110110111311111010111111111
114111111101111011113113001111
110011110000011101111003111100
111111101111011111111151133110
111011115151111104411311411111
111111111111310140101111001111
111411011111101111140111110111
111111110110111311111111311114
111101111011111110111111011430
011111111511101111001013051013
111111115110141111111111111101
111111011110010110111141111011
111110001111111544101413010113
131131411111111141111101101010
