00000000000000000000000000000000000000000000000000000000000000000000000000000000
00000000000000000000000000000000000000000000000000000000000000000000000000000000
00000000000000000000000000000000000000000000000000000000000000000000000000000000
00000000000000000000000000000000000000000000000000000000000000000000000000000000
00000000000000000000000000000000000000000000000000000000000000000000000000000000
00000000000000000000000000000000000000000000000000000000000000000000000000000000
00000000000000000000000000000000000000000000000000000000000000000000000000000000
00000000000000000000000000000000000000000000000000000000000000000000000000000000
00000000000000000000000000000000000000000000000000000000000000000000000000000000
00000000000000000000000000000000000000000000000000000000000000000000000000000000
00000000000000000000000000000000000000000000000000000000000000000000000000000000
00000000000000000000000000000000000000000000000000000000000000000000000000000000
00000000000000000000000000000000000000000000000000000000000000000000000000000000
00000000000000000000000000000000000000000000000000000000000000000000000000000000
00000000000000000000000000000000000000000000000000000000000000000000000000000000
00000000000000000000000000000000000000000000000000000000000000000000000000000000
00000000000000000000000000000000000000000000000000000000000000000000000000000000
00000000000000000000000000000000000000000000000000000000000000000000000000000000
00000000000000000000000000000000000000000000000000000000000000000000000000000000
00000000000000000000000000000000000000000000000000000000000000000000000000000000
00000000000000000000000000000000000000000000000000000000000000000000000000000000
00000000000000000000000000000000000000000000000000000000000000000000000000000000
00000000000000000000000000000000000000000000000000000000000000000000000000000000
00000000000000000000000000000000000000000000000000000000000000000000000000000000
00000000000000000000000000000000000000000000000000000000000000000000000000000000
00000000000000000000000000000000000000000000000000000000000000000000000000000000
00000000000000000000000000000000000000000000000000000000000000000000000000000000
00000000000000000000000000000000000000000000000000000000000000000000000000000000
00000000000000000000000000000000000000000000000000000000000000000000000000000000
00000000000000000000000000000000000000000000000000000000000000000000000000000000
22222222222222222222222222222222222222222222222222222222222222222222222222222222
11311111411111111111111151110111111513411111111131511111100111111111131011131111
11111113411115311111111111111411111101111101111111111113011111111111311111114111
11111113451440311111113113111111111111111111114111311115103011131051111110011311
11141111113513111111111314111111141110111131341111111011101311111314111133111111
10111111411134111111510411411111311111111111154111111111113111111111111111311111
11011111113111111111111311113111111111111111101111111111314113501111311111113411
14131111311141111113111111311111141111111111441111111111144111111111151111111111
11111311314111311111111111111111441111410141111141134111113411131131111313111431
11111114111111111111010151111115111113313110311111113111113111111343310141111111
11111111111113111141111140113111111111110111111411111101111441111111113131111111
11114110111311111511111111113113111141111111111511111341111311111111311111111311
11111131151111111111111111141111101114114131111111113131311031111111313111300111
11111131111131111113111134111013131111111111131101111151111113111111311111111111
11111131131111114111153111111111011101111111110111141111311113111311111111111111
10111111113011143011111111111111111131533111511111111101101411141111111011111111
41101113011111111100111111111110111110111113111111101110111111111015111143111131
11151111111114141141110111111111311111111111111111111111114111111111113311131140
01111111111111111111111111111111111101441111313011113111111311111111131111111111
11343411141111131113111011111111111111143111113113111111154111311111411111111111
33111131111111111113110111111134311111314115111111111131111111111111113111411131
13111111111511051411311111141011101111111113111113113113111114313111511114141111
11133011311111111311011111351131111111111311111111111111111341111311131114511111
11311111101111111111431111014110111111111110341111113101411110131113114311114111
13111110411141111111111111154411111311151111111113111113111111113113111115543110
11011111311111111411101111111111311111411111111111310110411314111111114111113113
31111101111114311115111111014311111111141101111113111111111011331111311111111114
14111111111151111111111111111131110111110111111114111111113111113151111111111113
14111111111111111111101110141141110133311311114411110111013111141101311111111134
11111111111111111111111111111111111111111151111111111101111111111111331111301111
10115011111111111111113151111111511111111511111153114110101141111111113311111115
11111111113111111011311111131414111111331111115111111111111111311113111131111101
41411111111111110141131111151101141111411401114111141141144110111111115111311111
11141111111111111111110115131111111311311111111111501311011131111113101131111115
11511111111101111111131111411103111101110111031131111111130111111111111111311111
11131411111114104111110111111511113111131111111141114133131111131111111111111111
11111111111443111113133033111311133111111111111110111101111111111111111111113144
11111411111111111151110011411530111131311514111111111511133111115011110101111111
11313414111411111111111101300111111113110311111411111311531101111431131131111101
11114311111111411113111111114114011114451111111111141111101141104114111111431111
11413131114111110131111111111113311111104111111111110113111111111110151111011111
11030134111111013111151311111151113311111111111111111111134101111114111111111411
10111510011111111111111141111111111111114414111131111011311111411111111111111111
11311511131111114114341111511113411011111311131511111311141111311110111111141111
05411111151111111115011113311141111141113111513111101311111111111111111113113110
11311511311311411111111111111131111153411111111111111011311110341115111311051111
11113131111030111111011113111031331111411111111111131131111111114111111111315131
01101111311111111131343111333141101111111111434113141111311115131114111111114111
13311113133311115111131113144131511110115111151141051111411111111011314111101133
11111101111111510111114114111111111111131150311131113111110113111355111111111111
11111111411133101111103111111111311111111131111151111114113111011143111131111111
41131111313111111411511145111111111111011011311111151113411110110011011111101011
11111411411111111111111411314141111114114111311143131311111131311111311411011111
31111141111111111111111003111311111110311110111111411313411550111113111015111113
31111111111101114141411111113111111011101015111131331113111111111141010111311113
11111131151131311113111111113413111311411111111111011511131411151311111111111103
11111411111111111111111111114113114111131111111111111111111431111101111414110111
01411111111413113111115301131114111110113111110014113110111113111011031311111114
11111111111111111101101115311311111433113111114111111111111111111111111111014311
11111331111111110313141154113111141411113111114130111111111111111314551111111311
11111111311311131044311101111111111114131111311131131431031141413411111111131313
11111411111131311111113411111101111111431133111411111101101311111111111111111111
14111401101111111115111131131111111103111134111411115111141113331311111111111131
11151111144111111115131111111111111111411311141311111111111131131114111101111151
11131111111131141111411111141411111111111310111111114311113111111110111111131111
11141111111311111131114111111111111111111131011111313131115110311511111111111131
11111111111111101111111113111141111111111101131111111115111111111131111111111011
13011441115114111104111111110111311111101114151111313140114111011131113111411111
43141115013311143111111111111113111111141511101151131111011113111131111101141511
11111041110111111511111011111154113141111114131111111111110111311131130131111111
