600000000000000000000000000006
600000000000000000000000000006
600000000000000000000000000006
600000000000000000000000000006
600000000000000000000000000006
222222222222222222222222222222
550334011011110111011010111111
114110030114131110011311111010
111411101101111010011111011110
111011111311000111111111115101
111111141110111014131011301111
110311111111513111111101311411
100101111105111111131111101151
111113110011113111104151113110
111114111131111111133113111111
101411101111111101341111115111
011111111151141131011111104111
401041110011004131111110314111
010111111111114111100111111111
011111111111111411110110111110
101111030111111011111113101110
111301111111111045113133111111
111110111113011415100111111111
111411111110111111111140101411
111111110111011113000110113110
011113411111310111141101315111
111410511010101311111144110101
144110111111131101111001111113
110111111111111011514111111111
113131111130110101111011131101
111010011111311111101101111111
101111311111011101411110114111
111011014111111311011110115031
111110111003111111111311111113
113105111111113111011011111110
001011113101111315101111101111
511441101111111111111101111111
011111111111111411531011111010
111011110313011101111110111111
111311101311110411111111051150
115001143011501101111001131111
111111111101101110111110111111
131101111115113111111111331011
111114111111110111101111115113
101011101100111111111111101111
111111101111115115111111111431
111101140111111111101001111101
101111310011111113111111101111
111010111433111110114301104111
113111141110111111101411101113
110111011111111111110111011111
111111011401111503411141111511
110111311111111100111101101111
111131111311111110111110111011
011111111011301100111401111113
113051411411131111111151111111
113111111111031111001001141014
011115111101110111111115011153
111311010110104111110111051111
111113111110101114111011101110
151110111011115110111111411100
105111100111111014011111111101
003101011001110115101111331301
031111111111111111111111011111
110113111110111014111115113101
010140110311010111111110301111
111101110101151111113111101011
311111101111130011111011011011
101101111011111010100111111101
111311111311111111141111110111
011111111001111111114131111511
111113041311110015001111111110
111111111011111113111110001111
103110111111311111100110113113
100111011111111111010111111110
110011101451111111101131110111
110111003111000103014131153113
411410113311111111111111101111
011011011401111111111131111110
111111100111110110111111111101
311111001013141113011111101111
111101111111111101103100514111
011111111113011111011111111111
111111501111111010111113411131
441101111001304111110011011101
111115141131135135111113110011
131111101001100111111011011131
111111151311114111110111104111
111111111101033010111111000101
111511114111010111011111115101
110114101013111111131111011111
111111111110111411110111011111
031051501111110110111111100101
111111411111110010133311101110
110111115111011011101111100111
101011111110113010115111135113
111111510111113111115131111111
110101111011501111111150101111
311511111131111111111134151311
410100111011301130010101111101
