000000000000000000000000000000
000000000000000000000000000000
000000000000000000000000000000
000000000000000000000000000000
000000000000000000000000000000
222222222222222222222222222222
011111011511111110511114111000
100130130104111113011111111111
113101110111111111111103111411
501113111101133111111101111110
111011110011111111100111011111
110111113514110111111111131010
141110110010130010010131111011
101111111100111101111101111143
111011151141101111111111111110
111111111111113111110111011131
111111110103100111111411003115
111101011111111114111010111101
411111111011103111111111150111
111100010411111111011111411005
011111311111101104111011011110
110111013110411110113141111111
111111101111111111113111111144
130111011115011111111101111111
111111111115110013111111111111
110101145011111030131131110111
111131111031101110110011101111
131011511110111111101111101111
311111111111110111111011111111
001311111101111013111111001113
101111104111111101411011011101
111114131111011110111113111111
150101110101101031011131111101
310111131111111111111111101401
111311111111111011111131111111
111100101111111031341111111113
101111111110111111111101141111
111111111115101130311111101111
111111110111011101013100111010
101411013111111111111111413011
133111111111115100111111101110
011011100111101010111111110151
110111111131111111111110011331
311141111111110110111111111111
011111111111130110114101111111
113111111111011011111111111011
101100110130101310101401110001
111151114011001011100111111111
111111103111111011110110110111
310130431101011111010014111100
111411311111110111040111011011
111111101111110111101111111015
010111410511131101011111010101
010511111311111111501010400115
111110101111041131131111111105
411011011014111011110113111113
111011133011111111110110131011
111101111110111010114111111111
351113411111110011111111111111
100110530100400111111110111411
411110113110311151111113101013
541111030113111111011111111111
011111110111101111111011111001
110111411111111111111111111311
151110113101111511503111111300
111110111111311111110111111111
110111131111011111011111111111
031111011110150111111110101111
111111310011114113111111111111
311011311111114010014101111101
340111111110113111110111111151
111141111011111031101001131111
111111111011010111411110113311
101113111111115413011101511011
111013011110110110011111131111
111110111010101111001131010111
111111131100113111111111011111
111111411111311111111111111111
111111501111111114110105111111
111111131111101011101113401031
031111101101111111151411511011
111011111011111111111111101111
111111111110111011111111100111
111311111141111101311001110111
111111140111011113130151111111
010111150111011111111131111111
114111111035111001301113111111
011111131110111111011111111001
110003003341011110141141100101
111111111101111111011130111110
111111000111400111111141111411
101111111111111111113111111111
113111101115111011131111411114
101101313101110101111111011111
111140101111111104114110101111
511110111015041311111111131011
111011111111111101111411110111
111111101101111140304111011111
011103110010111100410110111501
110111111011101110110111111011
